8
8
xsxxxxxx
x  x   x
xx xxx x
xx     x
xx xxx x
x    x x
x xx x x
xxxxexxx