8
8
xsxxxxxx
x     xx
  xxx xx
xxx    x
xxxxx xx
x     xx
x xx x x
xxxxexxx